5 8
#..M.M#X
S..##...
.#.M...#
...#.#.#
####..M#